Local Government Area,Overseas acquired,Locally acquired—contact known,Locally acquired—no known contact,Interstate acquired,Under investigation,Total,Date
Banana Shire,0,0,0,0,1,1,2021-12-24
Moreton Bay Regional,119,31,9,4,26,189,2021-12-24
Noosa Shire,19,5,3,1,26,54,2021-12-24
North Burnett Regional,1,1,0,1,1,4,2021-12-24
Not Supplied,64,8,1,0,96,169,2021-12-24
Paroo Shire,0,0,0,0,1,1,2021-12-24
Redland City,28,7,3,2,26,66,2021-12-24
Rockhampton Regional,21,1,0,0,1,23,2021-12-24
Somerset Regional,3,2,0,1,1,7,2021-12-24
Mareeba Shire,3,2,0,2,2,9,2021-12-24
South Burnett Regional,2,0,0,1,0,3,2021-12-24
Sunshine Coast Regional,82,14,5,10,39,150,2021-12-24
Tablelands Regional,4,0,0,0,0,4,2021-12-24
Toowoomba Regional,41,15,1,4,8,69,2021-12-24
Torres Shire,1,0,0,0,0,1,2021-12-24
Townsville City,31,1,0,3,10,45,2021-12-24
Western Downs Regional,3,0,0,0,4,7,2021-12-24
Whitsunday Regional,7,2,0,0,3,12,2021-12-24
Total,1582,646,113,143,1080,3564,2021-12-24
Southern Downs Regional,2,2,0,0,6,10,2021-12-24
Maranoa Regional,0,1,0,1,0,2,2021-12-24
Scenic Rim Regional,4,3,0,0,2,9,2021-12-24
Logan City,47,28,6,10,71,162,2021-12-24
Mackay Regional,22,4,0,1,1,28,2021-12-24
Bundaberg Regional,18,3,1,0,22,44,2021-12-24
Cairns Regional,43,9,5,3,8,68,2021-12-24
Cassowary Coast Regional,3,0,0,0,0,3,2021-12-24
Central Highlands Regional,0,1,1,0,1,3,2021-12-24
Charters Towers Regional,2,1,0,0,0,3,2021-12-24
Doomadgee Aboriginal Shire,0,0,0,0,1,1,2021-12-24
Douglas Shire,2,0,0,0,6,8,2021-12-24
Fraser Coast Regional,12,2,2,2,2,20,2021-12-24
Brisbane City,592,317,41,21,426,1397,2021-12-24
Gold Coast City,190,109,24,30,143,496,2021-12-24
Gladstone Regional,7,2,0,0,6,15,2021-12-24
Livingstone Shire,2,0,0,1,3,6,2021-12-24
Ipswich City,32,46,7,2,32,119,2021-12-24
Interstate/Other,166,13,3,41,99,322,2021-12-24
Lockyer Valley Regional,2,8,0,0,1,11,2021-12-24
Gympie Regional,4,2,1,0,2,9,2021-12-24
Goondiwindi Regional,2,6,0,2,3,13,2021-12-24
Hinchinbrook Shire,1,0,0,0,0,1,2021-12-24
Goondiwindi Regional,2,6,0,2,3,13,2021-12-25
Livingstone Shire,2,1,1,1,2,7,2021-12-25
Isaac Regional,0,0,0,0,4,4,2021-12-25
Ipswich City,32,49,11,2,38,132,2021-12-25
Interstate/Other,165,13,5,48,149,380,2021-12-25
Hinchinbrook Shire,1,0,0,0,0,1,2021-12-25
Lockyer Valley Regional,2,8,0,0,1,11,2021-12-25
Gympie Regional,4,3,1,0,3,11,2021-12-25
Gold Coast City,190,125,34,30,207,586,2021-12-25
Doomadgee Aboriginal Shire,0,0,0,0,1,1,2021-12-25
Fraser Coast Regional,12,2,2,2,2,20,2021-12-25
Douglas Shire,2,2,0,0,6,10,2021-12-25
Cook Shire,0,0,0,0,1,1,2021-12-25
Charters Towers Regional,2,1,0,0,0,3,2021-12-25
Central Highlands Regional,0,1,1,0,3,5,2021-12-25
Cassowary Coast Regional,3,0,0,1,0,4,2021-12-25
Cairns Regional,43,12,6,4,14,79,2021-12-25
Logan City,47,29,6,10,120,212,2021-12-25
Gladstone Regional,7,2,0,0,7,16,2021-12-25
Mackay Regional,22,5,0,1,3,31,2021-12-25
Total,1582,695,151,156,1738,4322,2021-12-25
Mareeba Shire,3,2,0,2,8,15,2021-12-25
Bundaberg Regional,18,4,1,0,48,71,2021-12-25
Whitsunday Regional,7,2,1,0,5,15,2021-12-25
Western Downs Regional,3,0,0,0,6,9,2021-12-25
Townsville City,31,1,1,3,16,52,2021-12-25
Torres Shire,1,0,0,0,0,1,2021-12-25
Toowoomba Regional,41,17,1,5,13,77,2021-12-25
Tablelands Regional,4,0,0,0,1,5,2021-12-25
Sunshine Coast Regional,82,15,6,13,76,192,2021-12-25
Southern Downs Regional,2,2,0,0,10,14,2021-12-25
South Burnett Regional,2,1,0,1,0,4,2021-12-25
Somerset Regional,3,2,1,1,1,8,2021-12-25
Scenic Rim Regional,4,3,0,0,6,13,2021-12-25
Rockhampton Regional,21,1,0,0,1,23,2021-12-25
Redland City,28,8,4,2,36,78,2021-12-25
Paroo Shire,0,0,0,0,1,1,2021-12-25
Not Supplied,64,11,5,0,155,235,2021-12-25
North Burnett Regional,1,1,0,1,2,5,2021-12-25
Noosa Shire,19,7,6,1,57,90,2021-12-25
Moreton Bay Regional,119,32,10,4,55,220,2021-12-25
Maranoa Regional,0,1,0,1,0,2,2021-12-25
Brisbane City,593,326,48,21,676,1664,2021-12-25
Banana Shire,0,0,0,0,1,1,2021-12-25
Whitsunday Regional,7,2,1,0,5,15,2021-12-26
Livingstone Shire,2,1,1,1,2,7,2021-12-26
Isaac Regional,0,0,0,0,4,4,2021-12-26
Ipswich City,32,49,11,2,38,132,2021-12-26
Interstate/Other,165,13,5,48,149,380,2021-12-26
Hinchinbrook Shire,1,0,0,0,0,1,2021-12-26
Gympie Regional,4,3,1,0,3,11,2021-12-26
Goondiwindi Regional,2,6,0,2,3,13,2021-12-26
Gold Coast City,190,125,34,30,207,586,2021-12-26
Lockyer Valley Regional,2,8,0,0,1,11,2021-12-26
Gladstone Regional,7,2,0,0,7,16,2021-12-26
Douglas Shire,2,2,0,0,6,10,2021-12-26
Doomadgee Aboriginal Shire,0,0,0,0,1,1,2021-12-26
Cook Shire,0,0,0,0,1,1,2021-12-26
Charters Towers Regional,2,1,0,0,0,3,2021-12-26
Central Highlands Regional,0,1,1,0,3,5,2021-12-26
Cassowary Coast Regional,3,0,0,1,0,4,2021-12-26
Cairns Regional,43,12,6,4,14,79,2021-12-26
Bundaberg Regional,18,4,1,0,48,71,2021-12-26
Fraser Coast Regional,12,2,2,2,2,20,2021-12-26
Brisbane City,593,326,48,21,676,1664,2021-12-26
Logan City,47,29,6,10,120,212,2021-12-26
Maranoa Regional,0,1,0,1,0,2,2021-12-26
Western Downs Regional,3,0,0,0,6,9,2021-12-26
Townsville City,31,1,1,3,16,52,2021-12-26
Torres Shire,1,0,0,0,0,1,2021-12-26
Toowoomba Regional,41,17,1,5,13,77,2021-12-26
Tablelands Regional,4,0,0,0,1,5,2021-12-26
Sunshine Coast Regional,82,15,6,13,76,192,2021-12-26
Southern Downs Regional,2,2,0,0,10,14,2021-12-26
South Burnett Regional,2,1,0,1,0,4,2021-12-26
Mackay Regional,22,5,0,1,3,31,2021-12-26
Somerset Regional,3,2,1,1,1,8,2021-12-26
Rockhampton Regional,21,1,0,0,1,23,2021-12-26
Redland City,28,8,4,2,36,78,2021-12-26
Paroo Shire,0,0,0,0,1,1,2021-12-26
Not Supplied,64,11,5,0,155,235,2021-12-26
North Burnett Regional,1,1,0,1,2,5,2021-12-26
Noosa Shire,19,7,6,1,57,90,2021-12-26
Moreton Bay Regional,119,32,10,4,55,220,2021-12-26
Mareeba Shire,3,2,0,2,8,15,2021-12-26
Scenic Rim Regional,4,3,0,0,6,13,2021-12-26
Banana Shire,0,0,0,0,1,1,2021-12-26
Total,1582,695,151,156,1738,4322,2021-12-26
Banana Shire,0,0,0,0,1,1,2021-12-27
Brisbane City,594,358,67,36,1084,2139,2021-12-27
Bundaberg Regional,18,4,1,0,97,120,2021-12-27
Cairns Regional,43,16,10,4,11,84,2021-12-27
Cassowary Coast Regional,3,0,0,1,0,4,2021-12-27
Central Highlands Regional,0,2,1,1,3,7,2021-12-27
Charters Towers Regional,2,1,0,0,0,3,2021-12-27
Cook Shire,0,0,0,1,0,1,2021-12-27
Doomadgee Aboriginal Shire,0,0,0,0,1,1,2021-12-27
Douglas Shire,2,2,0,0,6,10,2021-12-27
Fraser Coast Regional,12,3,2,2,8,27,2021-12-27
Gladstone Regional,7,2,0,1,13,23,2021-12-27
Gold Coast City,190,135,49,32,379,785,2021-12-27
Goondiwindi Regional,2,6,0,2,5,15,2021-12-27
Gympie Regional,4,4,1,0,4,13,2021-12-27
Hinchinbrook Shire,1,0,0,0,0,1,2021-12-27
Interstate/Other,166,21,9,52,238,486,2021-12-27
Ipswich City,32,49,11,2,104,198,2021-12-27
Isaac Regional,0,2,0,0,4,6,2021-12-27
Livingstone Shire,2,2,2,1,1,8,2021-12-27
Lockyer Valley Regional,2,8,0,0,3,13,2021-12-27
Logan City,47,37,12,12,238,346,2021-12-27
Mackay Regional,22,5,0,1,10,38,2021-12-27
Maranoa Regional,0,1,0,1,1,3,2021-12-27
Mareeba Shire,3,9,0,2,5,19,2021-12-27
Moreton Bay Regional,119,32,10,4,121,286,2021-12-27
Noosa Shire,19,14,8,1,84,126,2021-12-27
North Burnett Regional,1,1,0,1,2,5,2021-12-27
Not Supplied,65,13,12,1,267,358,2021-12-27
Paroo Shire,0,0,0,0,1,1,2021-12-27
Redland City,28,12,5,2,70,117,2021-12-27
Rockhampton Regional,21,1,0,0,6,28,2021-12-27
Scenic Rim Regional,4,4,0,0,8,16,2021-12-27
Somerset Regional,3,2,1,1,3,10,2021-12-27
South Burnett Regional,2,1,0,1,0,4,2021-12-27
Southern Downs Regional,2,2,0,0,12,16,2021-12-27
Sunshine Coast Regional,82,22,10,15,146,275,2021-12-27
Tablelands Regional,5,1,0,0,0,6,2021-12-27
Toowoomba Regional,41,17,1,5,35,99,2021-12-27
Torres Shire,1,0,0,0,0,1,2021-12-27
Townsville City,31,1,1,3,27,63,2021-12-27
Western Downs Regional,3,0,0,0,10,13,2021-12-27
Whitsunday Regional,7,3,1,0,12,23,2021-12-27
Total,1586,793,214,185,3020,5798,2021-12-27
Banana Shire,0,0,0,0,1,1,2021-12-28
Brisbane City,594,365,68,36,1430,2493,2021-12-28
Bundaberg Regional,18,4,2,0,111,135,2021-12-28
Cairns Regional,43,18,10,4,21,96,2021-12-28
Cassowary Coast Regional,3,1,0,1,1,6,2021-12-28
Central Highlands Regional,0,2,1,1,3,7,2021-12-28
Charters Towers Regional,2,1,0,0,0,3,2021-12-28
Cook Shire,0,0,0,1,0,1,2021-12-28
Doomadgee Aboriginal Shire,0,1,0,0,1,2,2021-12-28
Douglas Shire,2,2,0,0,6,10,2021-12-28
Fraser Coast Regional,12,3,2,2,12,31,2021-12-28
Gladstone Regional,7,4,1,1,11,24,2021-12-28
Gold Coast City,190,153,79,34,508,964,2021-12-28
Goondiwindi Regional,2,7,0,2,4,15,2021-12-28
Gympie Regional,4,5,1,0,6,16,2021-12-28
Hinchinbrook Shire,1,0,0,0,2,3,2021-12-28
Interstate/Other,166,21,12,57,329,585,2021-12-28
Ipswich City,32,50,12,2,160,256,2021-12-28
Isaac Regional,0,2,0,0,4,6,2021-12-28
Livingstone Shire,2,2,2,1,3,10,2021-12-28
Lockyer Valley Regional,2,8,0,1,6,17,2021-12-28
Logan City,47,37,12,12,337,445,2021-12-28
Mackay Regional,22,5,0,1,13,41,2021-12-28
Maranoa Regional,0,1,0,1,1,3,2021-12-28
Mareeba Shire,3,9,0,2,8,22,2021-12-28
Moreton Bay Regional,119,33,11,4,170,337,2021-12-28
Noosa Shire,19,18,10,2,99,148,2021-12-28
North Burnett Regional,1,1,0,1,2,5,2021-12-28
Not Supplied,65,18,12,2,356,453,2021-12-28
Paroo Shire,0,0,0,0,2,2,2021-12-28
Redland City,28,12,5,2,93,140,2021-12-28
Rockhampton Regional,21,2,1,1,9,34,2021-12-28
Scenic Rim Regional,4,4,1,0,8,17,2021-12-28
Somerset Regional,3,2,1,1,4,11,2021-12-28
South Burnett Regional,2,1,0,1,0,4,2021-12-28
Southern Downs Regional,2,3,0,2,10,17,2021-12-28
Sunshine Coast Regional,82,38,15,17,162,314,2021-12-28
Tablelands Regional,5,1,0,0,0,6,2021-12-28
Toowoomba Regional,41,21,1,5,89,157,2021-12-28
Torres Shire,1,0,0,0,0,1,2021-12-28
Townsville City,31,3,3,4,37,78,2021-12-28
Western Downs Regional,3,1,0,0,10,14,2021-12-28
Whitsunday Regional,7,3,1,0,20,31,2021-12-28
Total,1586,862,263,201,4049,6961,2021-12-28
Banana Shire,0,0,0,0,1,1,2021-12-29
Brisbane City,594,367,68,36,1885,2950,2021-12-29
Bundaberg Regional,18,5,2,0,135,160,2021-12-29
Cairns Regional,43,20,12,4,31,110,2021-12-29
Cassowary Coast Regional,3,1,0,2,1,7,2021-12-29
Central Highlands Regional,0,2,1,1,6,10,2021-12-29
Charters Towers Regional,2,1,0,0,0,3,2021-12-29
Cook Shire,0,0,0,1,0,1,2021-12-29
Doomadgee Aboriginal Shire,0,1,0,0,1,2,2021-12-29
Douglas Shire,2,2,0,0,7,11,2021-12-29
Fraser Coast Regional,12,3,2,2,18,37,2021-12-29
Gladstone Regional,7,6,2,1,14,30,2021-12-29
Gold Coast City,191,171,118,37,717,1234,2021-12-29
Goondiwindi Regional,2,8,0,2,4,16,2021-12-29
Gympie Regional,4,6,2,0,11,23,2021-12-29
Hinchinbrook Shire,1,0,0,0,2,3,2021-12-29
Interstate/Other,166,23,13,69,440,711,2021-12-29
Ipswich City,32,50,12,2,246,342,2021-12-29
Isaac Regional,0,2,0,0,4,6,2021-12-29
Livingstone Shire,2,4,2,1,15,24,2021-12-29
Lockyer Valley Regional,2,8,1,0,8,19,2021-12-29
Logan City,47,37,12,12,433,541,2021-12-29
Mackay Regional,22,7,0,1,19,49,2021-12-29
Maranoa Regional,0,1,0,1,1,3,2021-12-29
Mareeba Shire,3,10,0,2,8,23,2021-12-29
McKinlay Shire,0,0,0,0,1,1,2021-12-29
Moreton Bay Regional,119,33,11,4,228,395,2021-12-29
Mount Isa City,0,0,0,0,1,1,2021-12-29
Murweh Shire,0,0,0,0,2,2,2021-12-29
Noosa Shire,19,25,10,2,117,173,2021-12-29
North Burnett Regional,1,1,0,1,2,5,2021-12-29
Not Supplied,66,28,17,3,506,620,2021-12-29
Paroo Shire,0,0,0,0,3,3,2021-12-29
Redland City,28,12,5,2,116,163,2021-12-29
Rockhampton Regional,21,6,1,1,7,36,2021-12-29
Scenic Rim Regional,4,4,1,0,12,21,2021-12-29
Somerset Regional,3,2,1,1,7,14,2021-12-29
South Burnett Regional,2,1,0,1,0,4,2021-12-29
Southern Downs Regional,2,3,0,3,10,18,2021-12-29
Sunshine Coast Regional,82,46,21,17,197,363,2021-12-29
Tablelands Regional,5,1,0,0,2,8,2021-12-29
Toowoomba Regional,41,36,6,8,142,233,2021-12-29
Torres Shire,1,0,0,0,0,1,2021-12-29
Townsville City,31,3,3,4,51,92,2021-12-29
Weipa Town,0,0,0,0,1,1,2021-12-29
Western Downs Regional,3,2,0,0,11,16,2021-12-29
Whitsunday Regional,7,3,4,0,34,48,2021-12-29
Total,1588,941,327,221,5457,8534,2021-12-29
Banana Shire,0,2,0,0,1,3,2021-12-30
Brisbane City,594,368,69,36,2497,3564,2021-12-30
Bundaberg Regional,18,6,3,0,146,173,2021-12-30
Burdekin Shire,0,0,0,0,1,1,2021-12-30
Cairns Regional,43,26,12,4,48,133,2021-12-30
Cassowary Coast Regional,3,1,1,2,1,8,2021-12-30
Central Highlands Regional,0,2,1,1,6,10,2021-12-30
Charters Towers Regional,2,1,0,0,0,3,2021-12-30
Cherbourg Aboriginal Shire,0,0,0,0,3,3,2021-12-30
Cook Shire,0,0,0,1,0,1,2021-12-30
Doomadgee Aboriginal Shire,0,1,0,0,1,2,2021-12-30
Douglas Shire,2,2,0,0,9,13,2021-12-30
Fraser Coast Regional,12,3,2,2,28,47,2021-12-30
Gladstone Regional,7,8,2,1,16,34,2021-12-30
Gold Coast City,192,196,154,42,915,1499,2021-12-30
Goondiwindi Regional,2,8,0,2,4,16,2021-12-30
Gympie Regional,4,6,3,0,13,26,2021-12-30
Hinchinbrook Shire,1,0,0,0,2,3,2021-12-30
Interstate/Other,166,25,15,74,630,910,2021-12-30
Ipswich City,32,50,13,2,359,456,2021-12-30
Isaac Regional,0,3,0,0,4,7,2021-12-30
Livingstone Shire,2,10,3,1,8,24,2021-12-30
Lockyer Valley Regional,2,8,1,0,16,27,2021-12-30
Logan City,47,37,12,12,619,727,2021-12-30
Longreach Regional,0,0,0,0,1,1,2021-12-30
Mackay Regional,22,7,0,1,28,58,2021-12-30
Maranoa Regional,0,1,0,1,1,3,2021-12-30
Mareeba Shire,3,10,0,2,9,24,2021-12-30
McKinlay Shire,0,0,0,0,1,1,2021-12-30
Moreton Bay Regional,119,33,13,4,336,505,2021-12-30
Mount Isa City,0,0,0,0,3,3,2021-12-30
Murweh Shire,0,0,0,1,1,2,2021-12-30
Noosa Shire,19,26,10,2,136,193,2021-12-30
North Burnett Regional,1,1,0,1,2,5,2021-12-30
Not Supplied,66,33,23,2,786,910,2021-12-30
Paroo Shire,0,0,0,0,3,3,2021-12-30
Redland City,28,12,5,2,174,221,2021-12-30
Rockhampton Regional,21,10,2,1,23,57,2021-12-30
Scenic Rim Regional,4,4,1,0,16,25,2021-12-30
Somerset Regional,3,2,1,1,8,15,2021-12-30
South Burnett Regional,2,1,0,1,1,5,2021-12-30
Southern Downs Regional,2,3,0,3,21,29,2021-12-30
Sunshine Coast Regional,82,54,22,18,274,450,2021-12-30
Tablelands Regional,5,1,0,0,2,8,2021-12-30
Toowoomba Regional,41,58,8,9,196,312,2021-12-30
Torres Shire,1,0,0,0,11,12,2021-12-30
Townsville City,31,4,3,4,72,114,2021-12-30
Weipa Town,0,0,0,0,1,1,2021-12-30
Western Downs Regional,3,2,1,0,12,18,2021-12-30
Whitsunday Regional,7,4,5,0,71,87,2021-12-30
Total,1589,1029,385,233,7516,10752,2021-12-30
Balonne Shire,0,0,0,0,2,2,2021-12-31
Banana Shire,0,2,0,0,1,3,2021-12-31
Brisbane City,594,376,71,36,3483,4560,2021-12-31
Bundaberg Regional,18,6,3,0,169,196,2021-12-31
Burdekin Shire,0,0,0,0,1,1,2021-12-31
Cairns Regional,43,29,15,5,81,173,2021-12-31
Cassowary Coast Regional,3,1,1,2,1,8,2021-12-31
Central Highlands Regional,0,3,1,1,6,11,2021-12-31
Charters Towers Regional,2,1,0,0,0,3,2021-12-31
Cherbourg Aboriginal Shire,0,0,2,0,10,12,2021-12-31
Cook Shire,0,0,0,1,0,1,2021-12-31
Doomadgee Aboriginal Shire,0,1,0,0,1,2,2021-12-31
Douglas Shire,2,2,0,0,23,27,2021-12-31
Fraser Coast Regional,12,3,2,2,62,81,2021-12-31
Gladstone Regional,7,9,2,1,25,44,2021-12-31
Gold Coast City,192,228,207,45,1295,1967,2021-12-31
Goondiwindi Regional,2,8,0,2,4,16,2021-12-31
Gympie Regional,4,6,3,0,25,38,2021-12-31
Hinchinbrook Shire,1,0,0,0,5,6,2021-12-31
Interstate/Other,166,29,16,84,829,1124,2021-12-31
Ipswich City,32,69,21,2,468,592,2021-12-31
Isaac Regional,0,3,0,0,6,9,2021-12-31
Livingstone Shire,2,11,3,1,9,26,2021-12-31
Lockyer Valley Regional,2,8,1,0,35,46,2021-12-31
Logan City,47,37,12,12,852,960,2021-12-31
Longreach Regional,0,0,0,0,1,1,2021-12-31
Mackay Regional,22,9,3,1,45,80,2021-12-31
Maranoa Regional,0,1,0,1,3,5,2021-12-31
Mareeba Shire,3,10,0,2,10,25,2021-12-31
McKinlay Shire,0,0,0,0,1,1,2021-12-31
Moreton Bay Regional,119,33,13,4,480,649,2021-12-31
Mount Isa City,0,0,0,0,4,4,2021-12-31
Murweh Shire,0,0,0,1,1,2,2021-12-31
Noosa Shire,19,26,13,2,193,253,2021-12-31
North Burnett Regional,1,1,0,1,5,8,2021-12-31
Not Supplied,67,40,32,6,1108,1253,2021-12-31
Paroo Shire,0,1,0,0,2,3,2021-12-31
Redland City,28,14,5,2,258,307,2021-12-31
Rockhampton Regional,21,20,3,1,16,61,2021-12-31
Scenic Rim Regional,4,4,1,0,25,34,2021-12-31
Somerset Regional,3,2,1,1,8,15,2021-12-31
South Burnett Regional,2,1,0,1,14,18,2021-12-31
Southern Downs Regional,2,4,2,3,21,32,2021-12-31
Sunshine Coast Regional,82,58,25,18,350,533,2021-12-31
Tablelands Regional,5,1,0,0,6,12,2021-12-31
Toowoomba Regional,41,59,10,9,249,368,2021-12-31
Torres Shire,1,0,0,0,11,12,2021-12-31
Townsville City,31,10,5,4,79,129,2021-12-31
Weipa Town,0,0,0,0,1,1,2021-12-31
Western Downs Regional,3,3,1,1,15,23,2021-12-31
Whitsunday Regional,7,4,6,0,109,126,2021-12-31
Total,1590,1133,480,252,10408,13863,2021-12-31
Balonne Shire,0,0,0,0,2,2,2022-01-01
Banana Shire,0,2,0,0,1,3,2022-01-01
Brisbane City,594,377,72,36,4176,5255,2022-01-01
Bundaberg Regional,18,7,3,0,183,211,2022-01-01
Burdekin Shire,0,0,0,0,1,1,2022-01-01
Cairns Regional,43,38,22,7,97,207,2022-01-01
Cassowary Coast Regional,3,2,1,2,0,8,2022-01-01
Central Highlands Regional,0,3,1,1,6,11,2022-01-01
Charters Towers Regional,2,1,0,0,0,3,2022-01-01
Cherbourg Aboriginal Shire,0,0,2,0,19,21,2022-01-01
Cloncurry Shire,0,0,0,0,1,1,2022-01-01
Cook Shire,0,0,0,1,0,1,2022-01-01
Doomadgee Aboriginal Shire,0,1,0,0,1,2,2022-01-01
Douglas Shire,2,2,8,0,25,37,2022-01-01
Fraser Coast Regional,12,3,3,2,71,91,2022-01-01
Gladstone Regional,7,12,3,1,23,46,2022-01-01
Gold Coast City,193,247,246,46,1700,2432,2022-01-01
Goondiwindi Regional,2,8,0,2,4,16,2022-01-01
Gympie Regional,4,10,3,0,26,43,2022-01-01
Hinchinbrook Shire,1,0,0,0,11,12,2022-01-01
Interstate/Other,167,29,21,86,925,1228,2022-01-01
Ipswich City,32,72,33,2,564,703,2022-01-01
Isaac Regional,0,3,0,0,8,11,2022-01-01
Livingstone Shire,2,12,3,1,9,27,2022-01-01
Lockyer Valley Regional,2,8,1,0,40,51,2022-01-01
Logan City,47,37,13,12,1112,1221,2022-01-01
Longreach Regional,0,0,0,0,1,1,2022-01-01
Mackay Regional,22,10,4,1,55,92,2022-01-01
Maranoa Regional,0,1,0,1,5,7,2022-01-01
Mareeba Shire,3,11,0,2,10,26,2022-01-01
McKinlay Shire,0,0,0,0,1,1,2022-01-01
Moreton Bay Regional,119,33,13,4,632,801,2022-01-01
Mount Isa City,0,0,0,0,4,4,2022-01-01
Murweh Shire,0,0,0,1,1,2,2022-01-01
Noosa Shire,19,26,15,2,222,284,2022-01-01
North Burnett Regional,1,1,0,1,6,9,2022-01-01
Not Supplied,65,46,41,5,1201,1358,2022-01-01
Paroo Shire,0,1,0,0,3,4,2022-01-01
Redland City,28,14,5,2,318,367,2022-01-01
Rockhampton Regional,21,22,2,1,20,66,2022-01-01
Scenic Rim Regional,4,4,1,0,35,44,2022-01-01
Somerset Regional,3,2,1,1,13,20,2022-01-01
South Burnett Regional,2,1,0,1,17,21,2022-01-01
Southern Downs Regional,2,4,2,3,27,38,2022-01-01
Sunshine Coast Regional,82,63,28,18,408,599,2022-01-01
Tablelands Regional,5,1,0,0,9,15,2022-01-01
Toowoomba Regional,42,61,12,10,271,396,2022-01-01
Torres Shire,1,0,0,0,12,13,2022-01-01
Townsville City,31,11,5,4,93,144,2022-01-01
Weipa Town,0,0,0,0,1,1,2022-01-01
Western Downs Regional,3,3,1,1,22,30,2022-01-01
Whitsunday Regional,7,4,8,0,119,138,2022-01-01
Total,1591,1193,573,257,12511,16125,2022-01-01
Balonne Shire,0,0,0,0,2,2,2022-01-02
Banana Shire,0,2,0,0,5,7,2022-01-02
Brisbane City,594,379,72,36,5233,6314,2022-01-02
Bundaberg Regional,18,7,3,0,214,242,2022-01-02
Burdekin Shire,0,0,0,0,2,2,2022-01-02
Cairns Regional,43,45,21,8,197,314,2022-01-02
Cassowary Coast Regional,3,2,1,2,3,11,2022-01-02
Central Highlands Regional,0,3,1,1,8,13,2022-01-02
Charters Towers Regional,2,1,0,0,0,3,2022-01-02
Cherbourg Aboriginal Shire,0,0,2,0,28,30,2022-01-02
Cloncurry Shire,0,0,0,0,1,1,2022-01-02
Cook Shire,0,0,1,1,0,2,2022-01-02
Doomadgee Aboriginal Shire,0,1,0,0,1,2,2022-01-02
Douglas Shire,2,3,8,0,27,40,2022-01-02
Fraser Coast Regional,12,4,3,2,102,123,2022-01-02
Gladstone Regional,7,15,6,1,33,62,2022-01-02
Gold Coast City,193,246,246,46,2205,2936,2022-01-02
Goondiwindi Regional,2,8,0,2,7,19,2022-01-02
Gympie Regional,4,11,3,0,30,48,2022-01-02
Hinchinbrook Shire,1,0,0,0,14,15,2022-01-02
Interstate/Other,167,30,23,88,1156,1464,2022-01-02
Ipswich City,32,73,33,2,687,827,2022-01-02
Isaac Regional,0,3,0,0,17,20,2022-01-02
Livingstone Shire,3,14,3,1,11,32,2022-01-02
Lockyer Valley Regional,2,9,1,0,46,58,2022-01-02
Logan City,47,37,13,12,1400,1509,2022-01-02
Longreach Regional,0,0,0,0,1,1,2022-01-02
Mackay Regional,22,10,4,2,80,118,2022-01-02
Maranoa Regional,0,1,0,1,9,11,2022-01-02
Mareeba Shire,3,11,0,2,11,27,2022-01-02
McKinlay Shire,0,0,0,0,1,1,2022-01-02
Moreton Bay Regional,119,33,13,4,776,945,2022-01-02
Mount Isa City,0,0,0,0,6,6,2022-01-02
Murweh Shire,0,0,0,1,3,4,2022-01-02
Noosa Shire,19,27,16,2,268,332,2022-01-02
North Burnett Regional,1,1,0,1,10,13,2022-01-02
Not Supplied,65,57,46,7,1652,1827,2022-01-02
Palm Island Aboriginal Shire,0,0,0,0,5,5,2022-01-02
Paroo Shire,0,1,0,0,4,5,2022-01-02
Redland City,28,14,5,2,375,424,2022-01-02
Rockhampton Regional,21,31,5,1,27,85,2022-01-02
Scenic Rim Regional,4,4,1,0,41,50,2022-01-02
Somerset Regional,3,2,1,1,21,28,2022-01-02
South Burnett Regional,2,1,0,1,21,25,2022-01-02
Southern Downs Regional,2,4,2,3,27,38,2022-01-02
Sunshine Coast Regional,82,69,36,19,558,764,2022-01-02
Tablelands Regional,5,5,0,0,6,16,2022-01-02
Toowoomba Regional,42,61,12,10,338,463,2022-01-02
Torres Shire,1,0,0,0,11,12,2022-01-02
Townsville City,31,11,5,4,128,179,2022-01-02
Weipa Town,0,0,0,0,3,3,2022-01-02
Western Downs Regional,3,3,1,1,28,36,2022-01-02
Whitsunday Regional,7,8,13,0,165,193,2022-01-02
Total,1592,1247,600,264,16004,19707,2022-01-02
